{
  "camera_fov_deg": 62.0,
  "zone_to_aruco": {
    "100": 11,
    "200": 12,
    "300": 13,
    "400": 14,
    "500": 15,
    "600": 16,
    "700": 17,
    "800": 18,
    "900": 19
  }
}
